Mention Name	Original Entity Name	Revised Entity Name
华联控股	华联控股股份有限公司	华联控股
曲石乡	曲石乡	曲石镇
林允儿	林润娥	润娥
麦迪娜	麦迪娜·买买提	麦迪娜
洪尚秀	洪尚秀	洪常秀
罗玉凤	凤姐_(网络红人)	罗玉凤
李丹妮	李丹妮	李丹妮_(演员)
创维	创维数码	创维集团
格力电器	格力	格力电器
雷神2	雷神2	雷神2：黑暗世界
红塔山	红塔山牌香烟	红塔山香烟
林佳树	川岛茉树代	Yoshiki
联想控股	联想集团	联想控股
王麟	王麟	王麟_(歌手)
高俊熙	高濬熙	高准熹
谭杰希	谭杰希	谭佑铭_(歌手)
乐凯	中国乐凯集团有限公司	中国乐凯
中甲	中国足球甲级联赛	中国足球协会甲级联赛
斯巴达克斯	斯巴达克斯_(2010年电视剧)	斯巴达克斯_(电视连续剧)